WWWWWWWWWWWWWWWWWWWWWWWWWWWWWWWWWWWWWWWWWWWWWWWW
W....W...........W...WCCCCW........W.....W.....W
W....W...........W...WW.WWW........W.....W...C.W
W....W...........W....W.....W......WW....W.....W
W..............................................W
W..............................................W
W........................................WW..WWW
W....W..WWWWWW...W...........................WWW
W....W...........W.WW.......W.....W............W
W....WW..........W..........W.....W............W
W.....WWWWWW..WWWWWWWW..WWWWWW...WW............W
W............................WW...W............W
W..............................................W
W...WWWWWWWWWWW................................W
W...WW.........................WWWWWW......W...W
W...WC..WW....................WWWWC.W..W...W...W
W...WC........................WW.......W..WW...W
W...WW.............W..........W....C...W.......W
W....WWWWWWWWW....WW...................W.......W
W...........................................W..W
W..WWWWWWW....................W.............W..W
W........W....................WW...............W
W........W...................WWW..WWWW.........W
W..W..W..W...................W.......W....W....W
W..W..WCCW................................W.WWWW
W..W..WWWWWWWW............................W.W.CW
W..W.........W............................W.W..W
W..W..................W...................WWW..W
W..W.................WW..WW....................W
W..W.........W.....................WWW..WWW....W
W..WWWWWWWWWWW.......................W..WW.....W
W......................W.............W.........W
W.....................WW.....W.......W.........W
W.....................WC...WWW......WW.CWWW.CWWW
W.....S..............WW.....WWW.....WWWWWWWWWWWW
WWWWW...WWWWWWWWWWWWWWWWWWWWWWWWWWWWWWWWWWWWWWWW