WWWWWWWWWWWWWWWWWWWWWWWWWWWWWWWWWWWWWWWEEWWWWWWW
W....W...........W...WCCCCW........W.....W.....W
W....W...........W...WW.WWW........W.....W...C.W
W....W...........W....W.....W......WW....W.....W
W..............................................W
W..............................................W
W........................................WW..WWW
W....W..WWWWWW...W...........................WWW
W....W...........W..W.......W.....W............W
W....WW..........W..........W.....W............W
W.....WWWWWW..WWWWWWWW..WWWWWW...WW............W
W............................WW...W............W
W......WWWW....................................W
W...WWWW..WWWWW................................W
W...WW.........................WWWWWW......W...W
W...WC..WW....................WWWWC.W..W...W...W
W...WC........................WW.......W..WW...W
W...WW.............W..........W....C...W.......W
W....WWWWWWWWW....WW...................W.......W
W...........................................W..W
W..WWWWWWW....................W.............W..W
W........W....................WW...............W
W........W...................WWW..WWWW.........W
W..W..W..W...................W.......W....W....W
W..W..WCCW................................W.WWWW
W..W..WWWWWWWW............................W.W.CW
W..W.........W............................W.W..W
W..W..................W...................WWW..W
W..W.................WW..WW....................W
W..W.........W.....................WWW..WWW....W
W..WWWWWWWWWWW.......................W..WW.....W
W......................W.............W.........W
W.....................WW.....W.......W.........W
W.....................WC...WWW......WW.CWWW.CWWW
W.....S..............WW.....WWW.....WWWWWWWWWWWW
WWWWWEEEWWWWWWWWWWWWWWWWWWWWWWWWWWWWWWWWWWWWWWWW
# Enemies : (x ; y ; end ; direction ; delay ; stand_still)
6.5 ; 1.5 ; 6 ; 1 ; LOW ; 0
9 ; 5 ; 24 ; 0 ; LOW ; 0
19 ; 2 ; 4 ; 1 ; LOW ; 0
30 ; 2 ; 6 ; 1 ; LOW ; 0
44 ; 18 ; 0 ; 1 ; LOW ; 2
38 ; 15 ; 5 ; 1 ; HIGH ; 0
21 ; 11 ; 0 ; 1 ; LOW ; 4
24 ; 11 ; 0 ; 1 ; LOW ; 4
7 ; 16 ; 6 ; 0 ; HIGH ; 0
12 ; 22 ; 14 ; 0 ; LOW ; 0
1.5 ; 18.5 ; 8 ; 1 ; HIGH ; 0
29 ; 30 ; 0 ; 1 ; LOW ; 3
23 ; 30 ; 0 ; 1 ; LOW ; 2
40 ; 31 ; 4 ; 0 ; HIGH ; 0
32 ; 19 ; 2 ; 1 ; HIGH ; 0
44 ; 7 ; 0 ; 0 ; HIGH ; 1