XXXXXXXXXXXXXXXXXXXXXXXXXXXXXXXXXXXXXXXXXXXXXXXX
XOOOOXOOOOOOOOOOOXOOOXOOOOXOOOOOOOOXOOOOOXOOOOOX
XOOOOXOOOOOOOOOOOXOOOXXOXXXOOOOOOOOXOOOOOXOOOOOX
XOOOOXOOOOOOOOOOOXOOOOXOOOOOXOOOOOOXXOOOOXOOOOOX
XOOOOOOOOOOOOOOOOOOOOOOOOOOOOOOOOOOOOOOOOOOOOOOX
XOOOOOOOOOOOOOOOOOOOOOOOOOOOOOOOOOOOOOOOOOOOOOOX
XOOOOOOOOOOOOOOOOOOOOOOOOOOOOOOOOOOOOOOOOXXOOXXX
XOOOOXOOXXXXXXOOOXOOOOOOOOOOOOOOOOOOOOOOOOOOOXXX
XOOOOXOOOOOOOOOOOXOXXOOOOOOOXOOOOOXOOOOOOOOOOOOX
XOOOOXXOOOOOOOOOOXOOOOOOOOOOXOOOOOXOOOOOOOOOOOOX
XOOOOOXXXXXXOOXXXXXXXXOOXXXXXXOOOXXOOOOOOOOOOOOX
XOOOOOOOOOOOOOOOOOOOOOOOOOOOOXXOOOXOOOOOOOOOOOOX
XOOOOOOOOOOOOOOOOOOOOOOOOOOOOOOOOOOOOOOOOOOOOOOX
XOOOXXXXXXXXXXXOOOOOOOOOOOOOOOOOOOOOOOOOOOOOOOOX
XOOOXXOOOOOOOOOOOOOOOOOOOOOOOOOXXXXXXOOOOOOXOOOX
XOOOXOOOXXOOOOOOOOOOOOOOOOOOOOXXXXOOXOOXOOOXOOOX
XOOOXOOOOOOOOOOOOOOOOOOOOOOOOOXXOOOOOOOXOOXXOOOX
XOOOXXOOOOOOOOOOOOOXOOOOOOOOOOXOOOOOOOOXOOOOOOOX
XOOOOXXXXXXXXXOOOOXXOOOOOOOOOOOOOOOOOOOXOOOOOOOX
XOOOOOOOOOOOOOOOOOOOOOOOOOOOOOOOOOOOOOOOOOOOXOOX
XOOXXXXXXXOOOOOOOOOOOOOOOOOOOOXOOOOOOOOOOOOOXOOX
XOOOOOOOOXOOOOOOOOOOOOOOOOOOOOXXOOOOOOOOOOOOOOOX
XOOOOOOOOXOOOOOOOOOOOOOOOOOOOXXXOOXXXXOOOOOOOOOX
XOOXOOXOOXOOOOOOOOOOOOOOOOOOOXOOOOOOOXOOOOXOOOOX
XOOXOOXOOXOOOOOOOOOOOOOOOOOOOOOOOOOOOOOOOOXOXXXX
XOOXOOXXXXXXXXOOOOOOOOOOOOOOOOOOOOOOOOOOOOXOXOXX
XOOXOOOOOOOOOXOOOOOOOOOOOOOOOOOOOOOOOOOOOOXOXOOX
XOOXOOOOOOOOOOOOOOOOOOXOOOOOOOOOOOOOOOOOOOXXXOOX
XOOXOOOOOOOOOOOOOOOOOXXOOXXOOOOOOOOOOOOOOOOOOOOX
XOOXOOOOOOOOOXOOOOOOOOOOOOOOOOOOOOOXXXOOXXXOOOOX
XOOXXXXXXXXXXXOOOOOOOOOOOOOOOOOOOOOOOXOOXXOOOOOX
XOOOOOOOOOOOOOOOOOOOOOOXOOOOOOOOOOOOOXOOOOOOOOOX
XOOOOOOOOOOOOOOOOOOOOOXXOOOOOXOOOOOOOXOOOOOOOOOX
XOOOOOOOOOOOOOOOOOOOOOXOOOOXXXOOOOOOXXOOXXXOOXXX
XOOOOOOOOOOOOOOOOOOOOXXOOOOOXXXOOOOOXXXXXXXXXXXX
XXXXXOOOXXXXXXXXXXXXXXXXXXXXXXXXXXXXXXXXXXXXXXXX