WWWWWWWWWWWWWWWWWWWWWWWWWWWWWWWWWWWWWWWEEWWWWWWW
W....W...........W...WCCCCW........W.....W.....W
W....W...........W...WW.WWW........W.....W...C.W
W....W...........W....W.....W......WW....W.....W
W..............................................W
W..............................................W
W........................................WW..WWW
W....W..WWWWWW...W...........................WWW
W....W...........W.WW.......W.....W............W
W..............................................W
W.....WWWWWW..WWWWWWWW..WWWWWW...WW............W
W............................WW...W............W
W......WWWW....................................W
WWWWWEEEWWWWWWWWWWWWWWWWWWWWWWWWWWWWWWWWWWWWWWWW
# Enemies : (x ; y ; end ; direction ; delay ; stand_still)
6.5 ; 1.5 ; 6 ; 1 ; LOW ; 0