WWEEEWWWWWWWWWWWWWWWWWWWWWW
W..S.........W........W...W
W............W........W...E
WWWW.........W........W...W
W........W...WC.WW....WWWWW
W.C......W...WW...........W
W........W....WWWW........W
WWW......W...CW...........W
W........W....W...........W
W........W...WW...........W
W........W...W............W
W...W...WW...W...WW..W....W
W.......W....W...W...W....W
W...WWWWWC...W...WCCCW....W
W.......W....W...WWWWW....W
W.......WW...W....W.......W
W...W....W........W.......W
W...W.CC.W........W.......W
W...W.CC.W........W.......W
WWWWWWWWWWWWWWWWWWWWEEEWWWW
#
2 ; 9 ; 7 ; 1 ; LOW ; 0
11 ; 2 ; 15 ; 1 ; LOW ; 0
17 ; 9 ; 7 ; 0 ; LOW ; 0
14 ; 2 ; 0 ; 0 ; LOW ; 3
24 ; 2 ; 0 ; 0 ; LOW ; 4